0000000000000000
0000000111111110
0000111111111110
0001111111111000
0001111111110000
0001111111111100
0000011111111110
0011111111111110
0111111111111110
0111111111111000
1111111111000000
1111111000000000
1110000000000000
0000000000000000
0000000000000000
0000000000000000